44444444444444444444
50000000000000000004
50000030000000005004
50000030000000005004
52222220000000005004
50000030000000005004
50000030000000005004
50000033333003333004
50000030000000003004
50000000000000003004
50000033000000003004
50000035333333333004
50000550000000000004
50000565555555555554
50000022000000000005
50000022000000000005
50000022000000000005
60000000000000000005
62222220000004444444
62222220000000444444
62222222220000044444
55555555522200000444
51111000000000000004
51000000000000000004
51111000000000000004
53333333333333333333
