55555555555555555555555555555555555
45550000000000000000000000000000004
45000044444444444444444444000000004
40002333333333333333333333000000004
40002300000000000000000000000000004
40002300000000000000000000032000004
40002300002222222222220000032000004
40002300002111111111120000032000004
40002300002100000000120000032000004
40002300002100010000200000032000004
40002300002100111000000000032000004
40002300002100010000220000032000004
40002300002100000000120000032000004
40002300002111111111120000032000004
40002300002222222222220000033000004
40002300000000000000000000032000004
40000000000000000000000000032000004
40000003333333333333333333330000004
40000044444444444444444444400000054
40000000000000000000000000000000554
40000000000000000000000000000005554
55555555555555555555555555555555555