555555555555555555
200000000000000003
200000000000000003
200000000000000003
200000000000000003
200045000000000003
200045000000000003
200045333333300003
200045444444400003
200045000000000003
200045000000000003
200045000022222223
200045000055555553
200045000000000003
200045000000000003
200045333333300003
200045444444400003
200045000000000003
200045000000000003
200045000022222223
200045000055555553
200045000000000003
200045000000000003
200045333333300003
200045444444400003
200045000000000003
200045000000000003
200045000022222223
200045000055555553
200045000000000003
200045000000000003
200045333333300003
200045444444400003
200045000000000003
200045000000000003
200045000022222223
200045000055555553
200045000000000003
200045000000000003
200045333333300003
200045444444400003
200045000000000003
200045000000000003
200045000022222223
200045000055555553
200045000000000003
200045000000000003
200045333333300003
200045444444400003
200045000000000003
200045000000000003
200045000022222223
200045000055555553
200045000000000003
200045000000000003
200045333333300003
200045000000000003
200000000000000003
200000000000000003
200000011000000003
200000111110000003
200111111111110003
111111111111111111